[
        "--------------------------------------------------------------------------------------------------------------------------------------------------------------------------------------------------------------------------------------------------------",
        "-                                                                                                                                                                                                                                                      -",
        "-                                                                                                                                                                                                                                                      -",
        "-                                                                                                                                                                                                                                                      -",
        "-                                                                                                                                                                                                                                                      -",
        "-=                                                    .                                                                            _                                                                                                                   -",
        "-                                                                                                        =                                                                                                                                             -",
        "-                                                  _                               =                                                                                                                                                                   -",
        "-      =           =                                                                                                                                     ==                                                                                            -",
        "-                                                                                          .                                                                                                                                                           -",
        "-                                                                                           *   *                                                                                                                                                      -",
        "-                                                                                           _                                                                                                                                                          -",
        "-                                                    _                                                                                                                                                                                                 -",
        "-                                 =                                                                                                           *                                                                                                        -",
        "-                                                                                                                                           =                                                                                                          -",
        "-                                                     .                                                       *                                                                                                                                        -",
        "-     =                                                                                                       =                                                                                                                                        -",
        "-                 *  *                          =         =                                                                                                                                                                                            -",
        "-               =   =                                                                                                                                                                                                                                  -",
        "-                    .                                                                                                                                                                                                                                 -",
        "-                                   * *                                                                                                                                                                                                                -",
        "--------------------------------------------------------------------------------------------------------------------------------------------------------------------------------------------------------------------------------------------------------",
    ]

player 55 55
enemy 300 600 2 1 150 10
enemy 800 800 2 3 150 150
enemy 600 1200 2 3 150 100

/